WWWWWWWWWW
WWWW     W
W        W
W  W     W
WWWWWWWWWW