WWWWWWWWWWW
WWW  BW PWW
WWW WWWW WW
WWW WWWW WW
WWW W  W WW
W        WW
WWW WWWWWWW
WWW WWWWWWW
WWWWWWWWWWW
