WWWWWWWWWWWWWW
ETT         BE
ETT          E
E            E
E    TT      E
Ed   TT S    E
WWWWWWWWWWUWWW
