WWWWWWWWWWWWWW
WWW         BW
WWW          W
W            W
W    WW      W
WP   WW S    W
WWWWWWWWWWUWWW
