WWWWnWWWWWW
WWW  BT PWW
WWW WWWW WW
WWW WWWW WW
WWW W  W WW
W        WW
WWW WWWWWWW
WWWSWWWWWWW
WWWWWWWWWWW
