WWWWWWWWWWWWWW
WWW         BW
WWW          W
W            W
W    WW      W
Wd   WW S    W
WWWWWWWWWWUWWW
