WWWWWWWWWWWWWW
WWW         BW
WWW          W
W            W
W    WW      W
W    WW S    W
WWWWWWWWWWWWWW
