WWWWWWWWW
W     P W
WS      W
W       W
W       W
W       W
D       W
W      BW
WWWWWWWWW
