WWWWWWWWWW
W        W
WS       W
W        W
W        W
W        W
W        W
W        W
W       BW
WWWWWWWWWW
