WWWWUWWWWWW
WWW  BW PWW
WWW WWWW WW
WWW WWWW WW
WWW W  W WW
W        WW
WWW WWWWWWW
WWWSWWWWWWW
WWWWWWWWWWW
